######################################################################################
####bBb######bbb#######TbT#####################tbb######TBt#######BtT#################
####bBBbB#######tTb#######tbBtB################TBbTb#######btB#######Bbbtb############
###tb....b#..............#.....t#tBb##########Bt....b#..............#.....b#bBt#######
##b..............................................................#######...#...B..t###
##B........#..#.....#.#.....#...#.........###t........#..#.....#.#.....#...#.........#
#t.........#..#..##.#.#..##.#...#..........#B.........#..#..##.#.#..##.#...#..........#
#B.........#..#..##.#.#..##.#...#.....................#..#..##.#.#..##.#...#..........#
#b.........#..#..##.#.#..##.#...#..........#t.........................................#
#t.........#..#..##.#.#..##.#...#..........#B.........#..#..##.#.#..##.#...#..........#
##t........#..#.....#.#.....#...#.........###B........#..#.....#.#.....#...#.........#
##T.......#..#######..#######...#.....b..t###b.......#..#######..#######...#.....T..b#
###Tb....................#..........................t#..............#.....b#tTt#######
###bBTBb#######...#######TtbTb###############bTbTb#######BtT......BbtBb#############
###############......####################################......######################
#############.......Tb.......##########################.......bT.......#############
###########........bBBtB........#####################........TbBTb........###########
#########.........TbbBtbbB.........##############.........tbBbtTBt.........#####
########......bTbBBTBTBTbBb....t...#############......tBbbtbBbTtbBT....B...######
######......tbBtbBTtBbTtBtB..........................tBtbbtTBbtBtbBt......#######
######.....tTBBtbtTbBbTBbTBt.....#############.....tbBbTBtBbTbTBbtBB.....#######
######....BbTBbTbBtTBtBbbBBBt....##############....TTbBbBTtbTbtTbtBT....#########
#######.....BbTbTbTtbBBTbT.....################.....TbtBBtbBbTbTBt.....##########
#########.....TtbTb.....bbBtB....################.....bbtBBb.....TbTbT....########
###########........b...........######################........t...........############
############.................#########################.................#############
############...........T.....#######################################################
########..............................##############################################
#######...............................##############################################
######.....................................#######
#####.......................................#######
#####...........#########.........#####....#######
####...........##.......##.........##......#######
###...........#...........#............###########
##......#.....#.....##......#.....#.....## #######
#..b.....Ttb##....##btb.....##.....t....b..#######
#..T...tbBbb#......#BTbbt...#......bBt...t.#######
#....bTBBt###......###BbTBB....B.......B..#######
#......t.......###........t......###......#######
#.........##########.............################
#..........###########..........################
#......B.......##.....b.............b.....#######
###########...........##...........##############
#################################################